1111111111
1P0010C0E1
1111111111