1111111111
1P00000C01
1110101111
1C001000E1
1111101111
1111111111