111111111
1C00000E1
100000001
1000P0001
111111111