111111111
1000000E1
1000C0001
1P0000001
111111111